****************
*         *   E*
******    *  ***
*    *    *    *
*    *    *    *
*    *    *    *
*S   *         *
****************