****************
*         *   E*
*         *  ***
*              *
*              *
*    *         *
*S   *         *
****************